1110101111
1110101001
1000111001
1111101111
0000100001
1010111101
1010100111
1111100101
1000111101
1110100101

